BAXTER	B AE K S T ER
BUZZ	B AH Z
FIND	F AY N D
GOODBYE	G UH D B AY
HELLO	HH AH L OW
HELLO(2)	HH EH L OW
LAND	L AE N D
LOWER	L OW ER
OFF	AO F
ON	AA N
ON(2)	AO N
POINT	P OY N T
QUAD	K W AA D
RAISE	R EY Z
THANK	TH AE NG K
THE	DH AH
THE(2)	DH IY
TO	T UW
TO(2)	T IH
TO(3)	T AH
TURN	T ER N
YOU	Y UW
